1,1,1,1,1,1,1,1,1,1,1,1,1,1,1,1,1,1,1,1,1,1,1,1,1,1,1,1,1,1
1,9,9,9,9,9,9,9,9,9,9,9,9,9,9,9,9,9,9,9,9,9,9,9,9,9,9,9,98,1
1,9,9,9,9,9,9,9,9,9,9,9,9,9,9,9,9,9,9,9,9,9,9,9,9,9,9,9,98,1
1,9,9,9,9,9,9,9,9,9,9,9,9,9,9,9,9,9,9,9,9,9,9,9,9,9,9,9,98,1
1,9,9,9,9,9,9,9,9,9,9,9,9,9,9,9,9,9,9,9,9,9,9,9,9,97,9,9,98,1
1,1,1,1,1,9,9,9,9,9,9,9,9,9,9,9,9,9,9,9,9,9,1,1,1,1,1,1,1,1
1,0,0,0,1,1,1,9,9,9,9,9,9,9,9,9,9,9,9,9,9,9,1,0,0,0,0,0,0,0
1,0,0,0,0,0,1,1,1,9,9,9,9,9,9,9,9,9,9,9,9,9,1,0,0,0,0,0,0,0
1,1,1,1,1,1,1,1,1,1,1,9,9,9,9,9,9,9,9,9,9,9,1,0,0,0,0,0,0,0
1,9,9,9,9,9,9,9,9,9,9,9,9,9,9,9,9,9,9,9,9,9,1,0,0,0,0,0,0,0
1,9,9,9,9,9,9,9,9,9,9,9,9,9,9,9,9,9,9,9,9,9,1,0,0,0,0,0,0,0
1,9,9,9,9,9,9,9,9,9,9,9,9,9,9,9,9,9,9,9,9,9,1,0,0,0,0,0,0,0
1,9,9,9,9,9,9,9,9,9,9,9,9,9,9,9,9,9,9,9,9,9,1,0,0,0,0,0,0,0
1,9,9,9,9,9,9,9,9,9,9,9,9,9,9,9,9,9,9,9,9,9,1,0,0,0,0,0,0,0
1,9,9,9,9,9,9,9,9,9,9,9,9,9,9,9,9,9,9,9,9,9,1,0,0,0,0,0,0,0
1,9,9,9,9,9,9,9,9,9,9,9,9,9,9,9,9,9,9,9,9,9,1,0,0,0,0,0,0,0
1,9,9,9,9,1,1,1,1,9,9,9,9,9,9,9,9,9,9,9,9,9,1,0,0,0,0,0,0,0
1,9,9,9,9,9,9,9,9,9,9,9,9,9,9,9,9,9,9,9,9,9,1,0,0,0,0,0,0,0
1,1,1,9,9,9,9,9,9,9,9,9,9,9,9,9,9,9,9,9,9,9,1,0,0,0,0,0,0,0
1,1,1,1,1,1,1,1,1,1,1,9,9,9,9,9,9,9,9,9,9,9,1,0,0,0,0,0,0,0
0,0,0,0,0,0,0,0,0,0,1,1,9,9,9,9,9,9,9,9,9,9,1,0,0,0,0,0,0,0
0,0,0,0,0,0,0,0,0,0,0,0,1,1,9,9,9,9,9,9,9,9,1,0,0,0,0,0,0,0
0,0,0,0,0,0,0,0,0,0,0,0,0,1,1,1,9,9,9,9,9,9,1,0,0,0,0,0,0,0
0,0,0,0,0,0,0,0,0,0,0,0,0,0,0,1,1,1,9,9,9,9,1,0,0,0,0,0,0,0
0,0,0,0,0,0,0,0,0,0,0,0,0,0,0,0,0,1,9,9,9,9,1,0,0,0,0,0,0,0
1,1,1,1,1,1,1,1,1,1,1,1,1,1,1,1,1,1,1,9,9,9,1,0,0,0,0,0,0,0
1,9,9,9,9,9,9,9,9,9,9,9,9,9,9,9,9,9,9,9,9,9,1,0,0,0,0,0,0,0
1,9,9,9,9,9,9,9,9,9,9,9,9,9,9,9,9,9,9,9,9,9,1,0,0,0,0,0,0,0
1,9,9,9,9,9,9,9,9,9,9,9,9,9,9,9,9,9,9,9,1,1,1,0,0,0,0,0,0,0
1,9,9,9,9,9,9,9,9,9,9,9,9,9,9,1,1,1,9,9,9,9,1,0,0,0,0,0,0,0
1,9,9,9,9,9,9,9,9,9,9,9,9,9,9,9,9,9,9,9,9,9,1,0,0,0,0,0,0,0
1,9,9,9,9,9,9,9,9,9,9,1,1,1,9,9,9,9,9,9,9,9,1,0,0,0,0,0,0,0
1,9,9,9,9,9,1,1,1,9,9,9,9,9,9,9,9,9,9,9,9,9,1,0,0,0,0,0,0,0
1,9,9,9,9,9,1,1,1,9,9,9,9,9,9,9,9,9,9,9,9,9,1,0,0,0,0,0,0,0
1,1,1,1,1,1,1,1,1,1,1,1,1,1,1,1,1,9,9,9,9,9,1,0,0,0,0,0,0,0
0,0,0,0,0,0,0,0,0,0,0,0,0,0,0,0,1,9,9,9,9,9,1,0,0,0,0,0,0,0
0,0,0,0,0,0,0,0,0,0,0,0,0,0,0,0,1,9,9,9,9,9,1,0,0,0,0,0,0,0
0,0,0,0,0,0,0,0,0,0,0,0,0,0,0,0,1,9,9,9,1,1,1,0,0,0,0,0,0,0
0,0,0,0,0,0,0,0,0,0,0,0,0,0,0,0,1,9,9,9,9,9,1,1,1,1,1,1,1,1
0,0,0,0,0,0,0,0,0,0,0,0,0,0,0,0,1,9,9,9,9,9,9,9,9,9,9,9,9,1
0,0,0,0,0,0,0,1,1,1,1,1,1,1,1,1,1,1,1,9,9,9,9,9,9,9,9,9,9,1
0,0,0,0,0,0,0,1,9,9,9,9,9,9,9,9,9,9,9,9,9,9,9,9,9,9,9,9,9,1
0,0,0,0,0,0,0,1,9,9,9,9,9,9,9,9,9,9,9,9,9,1,9,9,9,9,9,9,9,1
0,0,0,0,0,0,0,1,9,9,9,9,9,9,9,9,9,9,9,9,9,1,9,9,9,9,9,9,9,1
0,0,0,0,0,0,0,1,9,9,9,9,9,9,9,9,9,9,1,1,1,1,1,1,1,1,1,1,1,1
0,0,0,0,0,0,0,1,9,9,9,9,9,9,9,9,9,9,9,9,9,9,1,0,0,0,0,0,0,0
0,0,0,0,0,0,0,1,9,9,9,9,9,9,9,9,9,9,9,9,9,9,1,0,0,0,0,0,0,0
0,0,0,0,0,0,0,1,9,9,9,9,9,9,9,9,9,9,9,9,9,9,1,0,0,0,0,0,0,0
0,0,0,0,0,0,0,1,9,9,9,9,9,9,9,9,9,9,9,9,9,9,1,0,0,0,0,0,0,0
0,0,0,0,0,0,0,1,9,9,9,9,9,9,9,9,9,9,9,9,9,9,1,0,0,0,0,0,0,0
0,0,0,0,0,0,0,1,9,9,9,9,9,9,9,9,9,1,1,1,9,9,1,0,0,0,0,0,0,0
0,0,0,0,0,0,0,1,9,9,9,9,9,9,9,9,9,9,9,9,9,9,1,0,0,0,0,0,0,0
0,0,0,0,0,0,0,1,9,9,9,9,9,9,9,9,9,9,9,9,9,9,1,0,0,0,0,0,0,0
1,1,1,1,1,1,1,1,9,9,9,9,9,9,9,9,9,9,9,9,9,9,1,1,1,1,1,1,1,1
1,9,9,9,9,9,9,9,9,9,9,9,9,9,9,9,9,9,9,9,9,9,9,9,9,9,9,9,9,1
1,9,9,9,9,9,9,9,9,9,9,9,9,9,9,9,9,9,9,9,9,9,9,9,9,9,9,9,9,1
1,9,9,9,9,9,9,9,9,9,9,9,9,9,9,9,9,9,9,9,9,9,9,9,9,9,9,9,9,1
1,9,9,9,9,9,9,9,9,9,9,9,9,9,9,9,9,9,9,9,9,9,9,9,9,9,9,9,9,1
1,9,9,9,9,9,9,9,9,9,9,9,9,9,9,9,9,9,9,9,9,9,9,9,9,9,9,9,9,1
1,1,1,1,1,1,1,1,1,1,1,1,1,1,1,1,1,1,1,1,1,1,1,1,1,1,1,1,1,1